10 10
##########
#   #    #
#   #    #
#   ###  #
#        #
#  #    ##
###      #
#   ##   #
#      # #
##########